#TEXTURE ./assets/comp.xpm
#TEXTURE ./assets/brick.xpm
#TEXTURE ./assets/nuke.xpm
#TEXTURE ./assets/wall.xpm
#TEXTURE ./assets/wall1.xpm
#TEXTURE ./assets/wall2.xpm
#TEXTURE ./assets/wall3.xpm
#TEXTURE ./assets/iron.xpm
#TEXTURE ./assets/skulls.xpm
#TEXTURE ./assets/octopus.xpm
#TEXTURE ./assets/menu_back.xpm
#TEXTURE ./assets/menu_play.xpm
#TEXTURE ./assets/menu_editor.xpm
#TEXTURE ./assets/menu_quit.xpm
#TEXTURE ./assets/death.xpm
#PLAYER_POSITION 8000 0 4500
#ACTION 0 0 0, 0 10 0, 0, INFINITE_ROTATION
ROOM 1 2
1370 -250 5740 1690 -250 2240 1690 150 2240 1370 150 5740 0
1690 -250 2240 3990 -250 1250 3990 150 1250 1690 150 2240 0
3990 -250 1250 7170 -250 3350 7170 150 3350 3990 150 1250 0
7170 -250 3350 10200 -250 3630 10200 150 3630 7170 150 3350 0
10200 -250 3630 12030 -250 2700 12030 150 2700 10200 150 3630 0
12030 -250 2700 12260 -250 6000 12260 150 6000 12030 150 2700 0
12260 -250 6000 8000 -250 5940 8000 150 5940 12260 150 6000 0
8000 -250 5940 8240 -250 4810 8240 150 4810 8000 150 5940 0
8240 -250 4810 5770 -250 6050 5770 150 6050 8240 150 4810 0
5770 -250 6050 5620 -250 4980 5620 150 4980 5770 150 6050 0
5620 -250 4980 5380 -250 4360 5380 150 4360 5620 150 4980 0
5380 -250 4360 4370 -250 5430 4370 150 5430 5380 150 4360 0
4370 -250 5430 3870 -250 6150 3870 150 6150 4370 150 5430 0
3870 -250 6150 2850 -250 3900 2850 150 3900 3870 150 6150 0
2850 -250 3900 4020 -250 2660 4020 150 2660 2850 150 3900 0
4020 -250 2660 2180 -250 4370 2180 150 4370 4020 150 2660 0
2180 -250 4370 2330 -250 5450 2330 150 5450 2180 150 4370 0
2330 -250 5450 1870 -250 6030 1870 150 6030 2330 150 5450 0
1870 -250 6030 1370 -250 5740 1370 150 5740 1870 150 6030 0
